##########
#S.#.....#
#.##.###.#
#....#.#.#
####.#.#.#
#H...#.T.#
#.####.#.#
#......#G#
##########