#######
#S....#
#.###.#
#...#.#
#.#.T.#
#H#...G
#######